// Use http://centricle.com/tools/ascii-hex/ for hex codes
urlHelp=help/index.html
lastSaved=最后保存
currentFile=当前文件
toolbar=工具栏
save=保存
print=打印
cut=剪切
copy=复制
paste=粘贴
delete=删除
undo=撤销
redo=重做
select=选择
connect=连接
pan=画笔
zoomIn=放大
zoomOut=缩小
zoom=放缩
fit=适应大小
actualSize=实际大小
selectAll=选择全部
clearSelection=取消选择
shape=图形
format=样式
font=字体
group=分组
ungroup=取消分组
removeFromParent=从父容器删除
align=水平对齐
left=居左
right=居右
center=居中
top=居上
middle=垂直居中
bottom=居下
collapse=收起
expand=展开
toBack=设为最底层
toFront=设为最上层
enterGroup=进入组
exitGroup=退出组
layout=布局
horizontalTree=水平树状
verticalTree=垂直树状
fillColor=填充颜色
strokeColor=边框颜色
gradientColor=渐变颜色
bold=粗体
italic=斜体
fontColor=字体颜色
fontSize=字体大小
fontFamily=字体
examples=示例
newDiagram=新建
image=图像
opacity=透明度
selection=选择区域
editStyle=编辑样式
enterStyle=输入样式
enterColorname=输入颜色
enterImageUrl=输入图片URL
enterOpacity=输入透明度
enterFontsize=输入字体大小
enterFontfamily=输入字体
toggleRounded=圆角
toggleShadow=阴影
openHref=打开链接
show=显示
exportImage=导出图片
changesLost=所有改变将丢失
swimlanes=泳道
travelBooking=跟踪预订
notAvailable=不可用
